AbilityInfobox=AbilityInfobox
AbilityInfoboxNoncat=AbilityInfoboxNoncat
AdvArcInfobox=AdvArcInfobox
AnimeLocationInfobox=AnimeLocationInfobox
AnimePokémonInfobox=AnimePokémonInfobox
ArchetypeInfobox=ArchetypeInfobox
BadgeInfobox=BadgeInfobox
BattleEInfobox=BattleEInfobox
BattrioExpansionInfobox=BattrioExpansionInfobox
BattrioPuckInfobox=BattrioPuckInfobox
BerryInfobox=BerryInfobox
Blueinfobox=Blueinfobox
Boardgame Infobox=Boardgame Infobox
BookInfobox=BookInfobox
CDInfobox=CDInfobox
ChapInfobox=ChapInfobox
Chapterinfobox=Chapterinfobox
Character Infobox=Character Infobox
CharInfobox=CharInfobox
CharInfoboxUser=CharInfoboxUser
Company Infobox=Company Infobox
Console infobox=Console infobox
CountryInfobox=CountryInfobox
DeckInfobox=DeckInfobox
DuelInfobox=DuelInfobox
Dungeon infobox=Dungeon infobox
DWGame=DWGame
DWInfobox=DWInfobox
Pokémon Infobox=Pokémon Infobox
EnergyCardInfobox=EnergyCardInfobox
EpisodeInfobox=EpisodeInfobox
EpisodeInfobox2=EpisodeInfobox2
EpisodeInfoboxShort=EpisodeInfoboxShort
EpisodeInfoboxSpecial=EpisodeInfoboxSpecial
FA Infobox=FA Infobox
Facility infobox=Facility infobox
Fan site=Fan site
Ga-OleInfobox=Ga-OleInfobox
GenInfo=GenInfo
GlitchMoveInfobox=GlitchMoveInfobox
GlitchPkmnInfobox=GlitchPkmnInfobox
GlitchPkmnInfoboxNocat=GlitchPkmnInfoboxNocat
GlitchSpriteBox=GlitchSpriteBox
GymInfobox=GymInfobox
IllustStoryInfobox=IllustStoryInfobox
Infobox game=Infobox game
Infobox island=Infobox island
Infobox location=Infobox location
Infobox walkthrough=Infobox walkthrough
Infobox zone=Infobox zone
InfoboxBlock=InfoboxBlock
InfoboxTV=InfoboxTV
Item=Item
ItemInfobox=ItemInfobox
KingdomInfobox=KingdomInfobox
MagazineInfobox=MagazineInfobox
MastersChapInfobox=MastersChapInfobox
MastersEventInfobox=MastersEventInfobox
MastersInfobox=MastersInfobox
MastersSkillInfobox=MastersSkillInfobox
MDMoveInfobox=MDMoveInfobox
Merchandise Infobox=Merchandise Infobox
MerchCollectionInfobox=MerchCollectionInfobox
MezastarInfobox=MezastarInfobox
MoveInfobox=MoveInfobox
MoveInfoboxNoncat=MoveInfoboxNoncat
MovieInfobox=MovieInfobox
Mystery Dungeon location=Mystery Dungeon location
NintendoService=NintendoService
Podcast=Podcast
PokkénInfobox=PokkénInfobox
Pokémon Center Infobox=Pokémon Center Infobox
PokémoncardInfobox=PokémoncardInfobox
PokémonInfobox=PokémonInfobox
PokémonInfoboxNoncat=PokémonInfoboxNoncat
PokéstarMovie=PokéstarMovie
PokéWalkerInfobox=PokéWalkerInfobox
RangerLocationInfobox=RangerLocationInfobox
RegionInfobox=RegionInfobox
Ribbon=Ribbon
Route infobox=Route infobox
Season Infobox=Season Infobox
SeasonInfobox=SeasonInfobox
SkyEpInfobox=SkyEpInfobox
SleepIsland=SleepIsland
Song=Song
TCGEnergyCardInfobox=TCGEnergyCardInfobox
TCGExpansionInfobox=TCGExpansionInfobox
TCGGBInfobox=TCGGBInfobox
TCGPocketDeckInfobox=TCGPocketDeckInfobox
TCGPocketEventInfobox=TCGPocketEventInfobox
TCGPocketExpansionInfobox=TCGPocketExpansionInfobox
TCGPromoInfobox=TCGPromoInfobox
TCGTrainerCardInfobox=TCGTrainerCardInfobox
Team Infobox=Team Infobox
TehPerson=TehPerson
TFGCardInfobox=TFGCardInfobox
TFGCrystalInfobox=TFGCrystalInfobox
TFGInfobox=TFGInfobox
TFGPearlInfobox=TFGPearlInfobox
Theme Park Infobox=Theme Park Infobox
Tiddlywinks=Tiddlywinks
TournamentInfobox=TournamentInfobox
Town infobox=Town infobox
TrainercardInfobox=TrainercardInfobox
TrainerClassInfobox=TrainerClassInfobox
TrettaInfobox=TrettaInfobox
TrettaSetInfobox=TrettaSetInfobox
Trozei location infobox=Trozei location infobox
UniteInfobox=UniteInfobox
UserPokémonInfobox=UserPokémonInfobox
VolumeInfobox=VolumeInfobox
WarlordInfobox=WarlordInfobox
WarriorInfobox=WarriorInfobox
WeatherInfobox=WeatherInfobox
